NO ./textures/north.xpm
SO ./textures/south.xpm
WE ./textures/west.xpm
EA ./textures/east.xpm

F 80,120,160
C 200,200,200

11111111111111111111
10000000000000000001
10111111101111111101
10000000100000000001
10111110101111101101
10000000100000100001
10111111111110101101
10000000000000100001
10111111111110101101
10000000010000100001
10111110111111101101
10000010000000000001
10111011111111111001
1000000000000000N001
11111111111111111111
