NO ../textures/00.xpm
SO ../textures/00.xpm
WE ../textures/00.xpm
EA ../textures/00.xpm

F 220,100,0
C 225,30,0

111111
1N0000
111111
