NO ../textures/path_to_the_north_texture
SO ../textures/path_to_the_south_texture
WE ../textures/path_to_the_west_texture
EA ../textures/path_to_the_east_texture

F 1,100,0
C 225,30,0

1111111111111111111111111
1010000000110000000000001
1001000000000010000000001
1111111110110000011100001
1000000000110000011101111
1111011111111101110N100001
1111011111111101110101001
1100000011010101110000001
1000000000000000110000001
1000000000000000110101001
1100000111010101111101111
1111011111101011011110101
1111111111111111111111111