C 153,55,255
NO ../textures/stone_wall.xpm
EA ../textures/stone_wall.xpm
WE ../textures/stone_wall.xpm

F 104,79,43    
SO ../textures/stone_wall.xpm

11111111111111111
100000000000E011
1010100000001001
1000001000000001
1111111111111111
