NO ../textures/01.xpm
SO ../textures/01.xpm
WE ../textures/01.xpm
EA ../textures/01.xpm

F 1,100,0
C 225,30,0

111111111111111111111111   1111
1010000000110000000010001
10010000000000100010E0101
1111111110110000011100001
1000000000110000011101111
1111011111111101110100001
1111011111111101110101001
1100000011010101110000001
1000000000000000110000001
1000000000000000110101001
1100000111010101111101111
1111011111101011011110101
1111111111111111111111111